1111111111111
00010000000C1
1000011111001
1P0011E0C0001
1111111111111
