1111111111111
10001000000C1
1010001111001
1P1011E0C0001
1111111111111
